NO ./assets/imgs/mossy_64.xpm

SO ./assets/imgs/brown_64.xpm

WE ./assets/imgs/brick_64.xpm

EA ./assets/imgs/gray_64.xpm

DO  ./assets/imgs/crateover.xpm

F 220,100,0

C 225,30,0

        1111111111111111111111111
        1000000000110000000000001
        1011000001110000000000001
        1001000000000000000000001
111111111011000001110000000000001
10000000001100000111011111D111111
111101111111110111000000D0001
11110111111111011101010010001
11000000110101011100000010001
100000000000000011000000D0001
10000000000000001101010010N01
11000001110101011111011111D1111
11110111 1110101 101111010001
11111111 1111111 111111111111
