11111111
10010001
10010001
10010001
10100101
1N001001
11111111
