1111111111
1001010001
1000010101
1001010001
1000011011
1000000001
1000000001
1000001111
1N00000011
1111111111
