11111111
10010001
10000001
10010001
10010001
1N000001
11111111
